Esta é uma lista dos principais aeroportos internacionais do mundo, incluindo cidade/país onde está localizado e código IATA.


== África ==
Número de aeroportos - 31 aeroportos
País com maior número de aeroportos - Egito
Aeroporto mais movimentado - Aeroporto Internacional de Joanesburgo
Número de países - 17 países


== América do Norte ==


=== Canadá ===
Aeroporto Internacional Toronto Pearson - Toronto (YYZ)
Aeroporto Internacional Montréal-Mirabel - Montreal (YMX)
Aeroporto Internacional de Vancouver - Vancouver (YVR)
Aeroporto Internacional de Quebec - Quebec (YQB)
Aeroporto Internacional Ottawa Macdonald-Cartier - Ottawa (YOW)
Aeroporto Internacional Pierre Elliott Trudeau - Montreal (YUL)
Aeroporto Internacional de Calgary (YYC)
Aeroporto Internacional de Halifax (YHZ)


=== Estados Unidos ===
Aeroporto Internacional John F. Kennedy - Nova Iorque (JFK)
Aeroporto de LaGuardia - Nova Iorque (LGA)
Aeroporto Internacional de Newark - Newark (EWR)
Aeroporto Internacional Logan - Boston (BOS)
Aeroporto Internacional O'Hare - Chicago (ORD)
Aeroporto Internacional Washington Dulles - Washington, DC (IAD)
Aeroporto Ronald Reagan - Washington, DC (DCA)
Aeroporto Internacional de Atlanta Hartsfield-Jackson - Atlanta (ATL)
Aeroporto Internacional de Orlando - Orlando (MCO)
Aeroporto Internacional de Miami - Miami (MIA)
Aeroporto Internacional George Bush - Houston (IAH)
Aeroporto Internacional de Dallas-Fort Worth - Dallas (DFW)
Aeroporto Internacional de Los Angeles - Los Angeles (LAX)
Aeroporto Internacional McCarran - Las Vegas (LAS)
Aeroporto Internacional de Honolulu - Honolulu (HNL)
Aeroporto Internacional de San Francisco - San Francisco (SFO)
Aeroporto Internacional de Seattle-Tacoma - Seattle (SEA)
Aeroporto Internacional de Denver - Denver (DEN)
Aeroporto Metropolitano de Detroit Wayne County - Detroit (DTW)
Aeroporto Internacional de Lansing - Lansing (LAN)
Aeroporto Internacional de Sky Harbor - Phoenix (PHX)
Aeroporto Internacional Midway - Chicago (MDW)
Aeroporto Internacional de Salt Lake City - Salt Lake City (SLC)


=== México ===
Aeroporto Internacional Juarez - Cidade do México (MEX)
Aeroporto Internacional de Cancún - Cancún (CUN)
Aeroporto Internacional de Guadalajara - Guadalajara (GDL)
Aeroporto Internacional de Acapulco - Acapulco (ACA)
Aeroporto Internacional de Ciudad Obregón - Ciudad Obregón (CEN)


== América Central ==

Número de aeroportos - 17 aeroportos
País com maior número de aeroportos - República Dominicana
Aeroporto mais movimentado - Aeroporto Internacional Tocumen
Número de países - 12 países


=== Tabela com código IATA - Aeroportos da América Central ===


== América do Sul ==

Número de aeroportos - 41 aeroportos
País com maior número de aeroportos - Brasil, 34 aeroportos (21 ativos)
Aeroporto mais movimentado - Aeroporto Internacional de São Paulo-Guarulhos (GRU)
Número de países - 10 países


=== Brasil ===
Aeroporto Internacional Senador Nilo Coelho - Petrolina (PNZ)
Aeroporto Internacional de São Paulo - Gov André Franco Montoro - Guarulhos (GRU)
Aeroporto Internacional Juscelino Kubitschek - Lago Sul (BSB)
Aeroporto Internacional Antônio Carlos Jobim - Rio de Janeiro (GIG)
Aeroporto Internacional Eurico de Aguiar Sales - Vitória (VIX)
Aeroporto Internacional Luís Eduardo Magalhães - Salvador (SSA)
Aeroporto Internacional Tancredo Neves - Confins (CNF)
Aeroporto Internacional Pinto Martins  - Fortaleza (FOR)
Aeroporto Internacional Eduardo Gomes - Manaus (MAO)
Aeroporto Internacional Marechal Hugo da Cunha Machado - São Luís (SLZ)
Aeroporto Internacional Salgado Filho - Porto Alegre (POA)
Aeroporto Internacional Gilberto Freyre  - Recife (REC)
Aeroporto Internacional Afonso Pena - São José dos Pinhais (CWB)
Aeroporto Internacional Val de Cans - Júlio Cezar Ribeiro - Belém (BEL)
Aeroporto Internacional de Campinas-Viracopos - Campinas (VCP)
Aeroporto Internacional Governador Aluízio Alves - São Gonçalo do Amarante (NAT)
Aeroporto Internacional Presidente Castro Pinto - Bayeux (JPA)
Aeroporto Internacional Hercílio Luz - Florianópolis (FLN)
Aeroporto Internacional Atlas Brasil Cantanhede - Boa Vista (BVB)
Aeroporto Internacional Alberto Alcolumbre - Macapá - (MCP)
Aeroporto Internacional Governador Jorge Teixeira de Oliveira - Porto Velho (PVH)
Aeroporto Internacional Maestro Wilson Fonseca - Santarém (STM)
Aeroporto Internacional Marechal Rondon - Várzea Grande (CGB)
Aeroporto Internacional de Campo Grande - Campo Grande (CGR)
Aeroporto Internacional Zumbi dos Palmares - Rio Largo (MCZ)
Aeroporto Internacional de Foz do Iguaçu - Foz do Iguaçu (IGU)
Aeroporto Internacional de Cabo Frio - Cabo Frio (CFB)
Aeroporto Internacional de Cruzeiro do Sul - Cruzeiro do Sul (CZS)
Aeroporto Internacional de São Carlos - São Carlos (QSC)
Aeroporto Internacional Plácido de Castro - Rio Branco (RBR)
Aeroporto Internacional de Tabatinga - Tabatinga (TBT)
Aeroporto Internacional de Parnaíba - Parnaíba (PHB)
Aeroporto Internacional Santa Genoveva - Goiânia (GYN)
Aeroporto Internacional Comandante Gustavo Kraemer - Bagé (BGX)
Aeroporto Internacional de Ponta Porã - Ponta Porã (PMG)


== Ásia ==

Número de aeroportos - 157 aeroportos
País com maior número de aeroportos - China
Aeroporto mais movimentado - Aeroporto Internacional Haneda
Número de países - 36 países


=== Israel ===
Aeroporto Internacional Ben Gurion - Tel Aviv (TLV)
Aeroporto Internacional de Ovda - Eilat (VDA)


== Europa ==


=== Portugal e Espanha ===
Aeroporto Internacional Humberto Delgado - Lisboa, Portugal (LIS)
Aeroporto Internacional Francisco Sá Carneiro - Porto, Portugal (OPO)
Aeroporto Internacional da Madeira Cristiano Ronaldo, Madeira, Portugal (FNC)
Aeroporto Internacional de Faro - Faro, Algarve, Portugal (FAO)
Aeroporto Internacional João Paulo II - Ponta Delgada, Açores, Portugal (PDL)
Aeroporto Internacional das Lajes - Lajes (Praia da Vitória), Açores, Portugal (TER)
Aeroporto Internacional Adolfo Suárez-Barajas - Madrid, Espanha (MAD)
Aeroporto Internacional de Barcelona - Barcelona, Espanha (BCN)
Aeroporto Internacional de Palma de Maiorca-Son Sant Joan - Palma de Maiorca, Baleares, Espanha (PMI)
Aeroporto Internacional de Gran Canária - Las Palmas, Gran Canária, Espanha (LPA)
Aeroporto Internacional de Sevilha - Sevilha, Andaluzia, Espanha (SVQ)
Aeroporto de Málaga-Costa del Sol - Málaga, Andaluzia, Espanha (AGP)
Aeroporto Internacional de Tenerife - Tenerife, Canárias, Espanha (TFN)
Aeroporto Internacional de Manises - Valência, Valenciana, Espanha (VLC)
Aeroporto Internacional de Ibiza - Ibiza, Baleares, Espanha (IBZ)
Aeroporto Internacional de Santiago de Compostela - Santiago de Compostela, Galiza, Espanha (SCQ)
Aeroporto Internacional de Santa Maria - Ilha de Santa Maria, Açores Portugal (SMA)


===== França, Bélgica e Países Baixos =====
Aeroporto Internacional de Orly - Paris, França (ORY)
Aeroporto Internacional Charles de Gaulle - Paris, França (CDG)
Aeroporto Internacional de Toulouse-Blagnac - Toulouse, França (TLS)
Aeroporto Internacional de Lyon - Lyon, França (LYS)
Aeroporto Internacional de Strasbourg Entzheim - Estrasburgo, França (SXB)
Aeroporto Internacional de Nice-Côte d'Azur - Nice, França (NCE)
Aeroporto Internacional de Marseille-Provence - Marselha, França (MRS)
Euro-Aeroporto de Basel-Mulhouse-Freiburg - Basileia, Suíça / Mulhouse, França / Friburgo, Alemanha (BSL, MLH, EAP)
Aeroporto Internacional de Bruxelas - Bruxelas, Bélgica (BRU)
Aeroporto Internacional de Liège - Liège, Bélgica (LGG)
Aeroporto Internacional de Antuérpia - Antuérpia, Bélgica (ANR)
Aeroporto Internacional de Amsterdão Schiphol - Amesterdão, Países Baixos (AMS)
Aeroporto Internacional de Eindhoven - Eindhoven, Países Baixos (EIN)
Aeroporto Internacional de Roderdã-Haia - Roterdão, Países Baixos (RTM)


=== Reino Unido, Irlanda, Escandinávia, Rússia e Moldávia ===
Aeroporto Internacional de Heathrow - Londres, Reino Unido (LHR)
Aeroporto Internacional Gatwick - Londres, Reino Unido (LGW)
Aeroporto Internacional de Dublin - Dublin, Irlanda (DUB)
Aeroporto Internacional de Copenhague - Copenhague, Dinamarca (CPH)
Aeroporto Internacional Arlanda - Estocolmo, Suécia (ARN)
Aeroporto de Oslo - Oslo, Noruega (OSL)
Aeroporto Internacional Vantaa - Helsinki, Finlândia (HEL)
Aeroporto Internacional Sheremetyevo - Moscou, Rússia (SVO)
Aeroporto Internacional de Chişinău - Chişinău, Moldávia (AIM)


=== Alemanha, Áustria, Suíça, Itália e Polônia ===
Aeroporto Berlin-Tegel - Berlim, Alemanha (TXL)
Aeroporto Internacional de Frankfurt - Frankfurt, Alemanha (FRA)
Aeroporto de Munique-Franz Josef Strauss - Munique, Alemanha (MUC)
Aeroporto Internacional de Viena - Viena, Áustria (VIE)
Aeroporto de Zurique - Zurique, Suíça (ZRH)
Aeroporto Cointrin - Genebra, Suíça (GVA)
Aeroporto Internacional de Milão-Malpensa - Milão, Itália (MXP)
Aeroporto Linate - Milão, Itália (LIN)
Aeroporto Internacional Fiumicino - Roma, Itália (FCO)
Aeroporto de Roma Ciampino - Roma, Itália (CIA)
Aeroporto Marco Polo - Veneza, Itália (VCE)
Aeroporto Peretola - Florença, Itália (FLR)
Aeroporto Internacional Okęcie - Varsóvia, Polónia (WAW)


=== Grécia, Turquia e Leste Europeu ===
Aeroporto Internacional Eleftherios Venizelos - Atenas, Grécia (ATH)
Aeroporto Internacional Ataturk - Istambul, Turquia (IST)
Aeroporto Internacional Pleso - Zagreb, Croácia (ZAG)
Aeroporto Internacional Butmir - Sarajevo, Bósnia (SJJ)
Aeroporto Internacional de Belgrado - Belgrado, Sérvia (BEG)
Aeroporto Internacional de Kiev-Boryspil - Kiev, Ucrânia (KBP)
Aeroporto Internacional Vrazhdebna - Sófia, Bulgária (SOF)
Aeroporto Internacional Otopeni - Bucareste, Romênia (OTP)
Aeroporto de Budapeste Ferenc Liszt - Budapeste, Hungria (BUD)
Aeroporto Internacional Ruzyne - Praga, República Tcheca (PRG)


== Oceania ==

Número de aeroportos - 18 aeroportos
País com maior número de aeroportos - Austrália
Aeroporto mais movimentado - Aeroporto Internacional de Sydney
Número de países - 5 países


== Ver também ==
Lista de aeroportos por país


== Referências ==


== Ligações externas ==
«Informações acerca de dez mil aeroportos de todo o mundo e das distâncias entre eles.»