Esta é uma lista dos blocos do carnaval de Salvador.
Nana Banana — bloco comandado por Bell Marques
Coruja — bloco comandado por Ivete Sangalo
Camaleão — bloco comandado por Bell Marques
Vumbora?! — bloco comandado por Bell Marques
Bloco Eva — bloco comandado por Banda Eva
Bloco Papa — bloco comandado por Babado Novo
Balada — bloco comandado por Tuca Fernandes
Bloco Timbalada — bloco comandado por Timbalada
Crocodilo — bloco comandado por Daniela Mercury
Banana Coral D+ — bloco comandado por Oito7Nove4
Nuoutro — bloco comandado por Banda Eva e Psirico
Inter — bloco comandado por Psirico
Bloco Cheiro — bloco comandado por Cheiro de Amor
Bloco Olodum — bloco comandado por Olodum
Praieiro — bloco comandado por Jammil e Uma Noites
AfroPop — bloco comandado por Margareth Menezes
Ara Ketu — bloco comandado por Ara Ketu
Happy — bloco comandado por Tio Paulinho e Selva Branca
Aviões Elétrico — bloco comandado por Aviões do Forró
Bloco Blowout — bloco comandado por Claudia Leitte
Yes Bahia Club — bloco comandado por 5%
Cortejo Afro — bloco comandado por Banda Cortejo Afro
Pra Ficar — bloco comandado por
Bloco Largadinho — bloco comandado por Claudia Leitte
Algodão Doce — bloco comandado por Carla Perez
Cerveja & Cia — bloco comandado por Ivete Sangalo
Bloco Harém — bloco comandado por Alexandre Peixe
Bloco Pirraça — bloco comandado por Matheus e Kauan
Me Abraça — bloco comandado por Durval Lelys
Me Ama — bloco comandado por André Lelys
Coco Bambu — bloco comandado por Durval Lelys
Baby — bloco comandado por
Fissura — bloco comandado por Timbalada e Tomate
Meu e Seu — bloco comandado por Harmonia do Samba
As Muquiranas — bloco comandado por Léo Santana, Psirico e Parangolé
Traz a Massa — bloco comandado por Parangolé, Fantasmão, Black Style
Pinel — bloco comandado por Psirico e Bailão do Robyssão
Dinamite — bloco comandado por Gilmelândia


== Referências ==